111111111111111
100000000000001
111111000000011
     1000000001
     1000000001
     1000000111
     1000000001
     10000100111111111111
     10000000000000000001
     10000N00000001111111
     10000000000000000001
     11111111111111111111